### A #
####  #
#### #
#### ##
##
####B##